o,o,o,o,o,o,o,o,o,o,o
o,o,o,o,o,o,o,o,o,o,o
o,o,p,p,p,p,p,f,p,o,o
o,o,p,f,f,p,p,p,p,o,o
o,o,p,p,f,p,p,p,p,o,o
o,o,p,p,p,p,p,p,p,o,o
o,o,p,p,p,p,f,f,p,o,o
o,o,p,p,p,f,f,p,p,o,o
o,o,p,p,p,p,p,p,p,o,o
o,o,o,o,o,o,o,o,o,o,o
o,o,o,o,o,o,o,o,o,o,o